**************
    * *      *
* *   * * ****
* * * * *    *
* * ***   * **
* *     * *  *
*   * * ******
* * *** * *  *
* * *   *   **
* * * * * *   
**************