***********************
        * *     *     *
* * *** * * * *** *** *
* * *       *     *   *
* * ******* * * **** **
* *   *   * * *       *
* ******* ******* * ***
* *     *       * *   *
* *** ********* * *****
*             *        
***********************