**************
    * *      *
* *   * * ****
* * * * *    *
* * ***   * **
* *     * *  *
* * * ****** *
* * *** * *  *
* * *       **
* * * * * *   
**************