*************
  * * *     *
* * * * * ***
  *   * *   *
  * *** * * *
        * * *
* * * * * ***
* * * * *   *
*   *        
*************