************
$$$$$$$$$$$*
*****$**$***
*$$$$$$$$$$*
**$**$******
*$$$$$$$$$$*
**$***$*****
*$$$$$$$$$$$
************
