***********
*         *
***** ** **
*         *
           
***********