*************
  * * *     ****
* * * * * ***
* *   * *   ****
* * *** * * *
*       * * *
* * * * * ***
* * * * *    
*************