***********************
$$$$$$$$*$*$$$$$*$$$$$*
*$*$***$*$*$*$***$***$*
*$*$*$$$$$$$*$$$$$*$$$*
*$*$*******$*$*$****$**
*$*$$$*   *$*$*$$$$$$$*
*$******* *******$*$***
*$*$$$$$*     $$*$*$$$*
*$***$*********$*$*****
*$$$$$$$$$$$$$*$$$$$$$$
***********************