************
           *
***** ** ***
*          *
** ** ******
*          *
** *** *****
*           
************