**************
$$$$*$*$$$$$$*
*$*$$$*$*$****
*$*$*$*$*$$$$*
*$*$***$$$*$**
*$*$$$$$*$*$$*
*$*$*$******$*
*$*$*** * *$$*
*$*$*    $$$**
*$*$* * * *$$$
**************
